20	15
2	2	2	2	2	2	2	2	2	2	2	2	2	2	2	2	2	2	2	2
2	0	0	0	2	0	0	0	4	4	4	4	4	0	0	0	0	0	0	2
2	0	0	0	2	0	0	0	4	4	4	4	4	0	0	0	7	0	0	2
2	0	0	0	2	0	0	2	4	4	4	4	4	0	0	0	0	0	0	2
2	0	0	0	2	0	0	2	4	4	4	4	4	0	0	0	0	0	0	2
2	0	0	0	2	9	0	2	4	4	4	4	4	0	0	0	0	0	0	2
2	0	0	0	2	2	2	2	4	4	4	4	4	0	0	0	0	0	0	2
2	0	0	0	0	0	0	0	0	0	0	0	0	0	0	0	0	0	0	2
2	0	6	0	0	0	0	0	0	0	0	0	0	0	0	0	0	4	4	2
2	0	0	0	0	0	0	0	0	0	0	0	0	0	0	0	0	0	0	2
2	0	0	0	0	0	0	0	0	0	2	0	0	0	0	0	0	0	0	2
2	0	6	0	0	0	0	0	0	0	2	2	2	2	2	2	0	0	0	2
2	0	0	0	0	0	0	0	0	0	2	0	0	0	0	0	0	0	9	2
2	0	0	0	0	0	0	0	0	0	2	5	0	0	0	0	0	0	0	2
2	2	2	2	2	2	2	2	2	2	2	2	2	2	2	2	2	2	2	2